Chapter01	9	8	-400	337.5	0			
0	0	0	0	0	0	0	0	0
0	0	0	0	0	1	3	0	0
0	0	1	1	9	1	1	0	0
0	0	1	9	1	9	0	0	0
0	1	1	0	0	0	0	0	0
0	1	5	1	1	5	1	0	0
0	1	5	1	5	1	1	33	0
0	0	0	0	0	0	0	0	0
