2,9,8,-400,378,0,32,0,0
0,0,0,0,0,0,0,0,0
0,0,1,1,1,1,0,0,0
0,0,9,0,17,17,1,1,0
0,1,17,0,0,5,5,5,0
0,1,1,0,0,1,17,1,0
0,3,1,0,0,1,9,1,0
0,0,0,0,0,33,1,9,0
0,0,0,0,0,0,0,0,0
