2,9,8,-400,378,0,32,0,0
0,0,0,0,0,0,0,0,0
0,0,1,1,1,1,0,0,0
0,0,1,0,1,1,1,1,0
0,1,1,0,0,1,1,1,0
0,1,1,0,0,1,1,1,0
0,1,1,0,0,1,1,1,0
0,0,0,0,0,1,1,1,0
0,0,0,0,0,0,0,0,0
